G G G F G G G G G G G G G G E
G TLRRRRR G F W W W G G G S G G THLLLLB G
G F G G G G G G G F G G S G E
G TDRRRRR G G G G F G S G G G G TLLLLLB G
G THRRRRR G G G W F F W G G G THLLLLB G E
G TLRRRRR G G G G S G F G G G G TDLLLLB G
G S G G F G G G G G G G F G E
G THRRRRR G G S G G G W W W F G TLLLLLB G
G G G G G G G G G G F G G G E